11111111111111111
1000000000C0000T1
1000000T000000001
1E000T000C0000001
1000000P000000001
1000000T00T000001
11111111111111111