111111111111111111111
1E00000000000T000C001
1000T0000111000000001
1000C0000T00000000001
10000T000001111000001
1000000000000000000T1
10000T000000000C00001
111111000C0000T000001
1000T0000001111111101
10000PT001T00C000C0C1
111111111111111111111