1111111
1P00E01
100C001
1111111