111111111111111111111
1E0000000000000000001
100000C0011100C000001
10000000000C00C000001
1CCCCCCCCCC1111CCCCC1
100C0000000000C000001
1CCCCCCCCCCCCCCCCCCC1
111111CCCCCCCC1111111
1CCCCCCCCCCCCCCCCCCC1
100C00P01000CCCCCCCC1
111111111111111111111